1111111111111
10100000000C1
1000011111001
1P00100000001
1111111111111