1111111111111
10100000000C1
1000011111001
100010E000001
1111111111111