1111111111111
10100000000C111
1000011111001
1P0010E000001
111111111111100