11111111111111
10010C000000C1
10000111110001
11101110C10101
1C0000000100C1
10000111110101
1P0011E000C001
11111111111111
