11111111111111
1C0100000000C1
10000111110001
11101110C10101
1C0000000100C1
1000011111E101
1P0011E0000001
11111111111111